Ya  	

Pakistan  	

Itna lmba urd he wo 	

Nai mnt mail krta hu 	

Linked in py tahir akhtar k name sy 	

Hahahahah  	

Han khryt thi  	

Fre nhi hua? 	

Me abbas n khuram going acadmy 	

Boss kheriyat thi??? suba yad kita mere ko 	

Nhe  : sy tk fre hun sy clas hy 	

Hotmail pe kr di 	

Email send krna 	

Tahirmesp  @gmail.com 	

Bhr ayn ma bhr khra hn 	

Wo shop chor gy han yahn sa 	

Aoa.hru?When will u free 	  krta hu pta  

Khala k potay ki death hogye he. 	

O menu pta c.ham shekhupura ja rahay hen 	

Sona hi he rat ko 	

Chl dafa ho tu b. 	

Mooday knjr ne jawab de dia hai. Asim sham ko btae ga. To phr hum log he mil lein? 	

Kia kr rahe ho aj rat. 	  

Mil gye email 	

Krta hn bati band he abi 	

is pe mail krna 	 direct lga do on off swich lga k but fan direct he 

Chek ur mail 	

bai jan Linear Algebra by W k Nicolson  rd editiön.is ka soft copy me solution  he pra kia?  	 milvi se pushna he

Gas kb ki dali he? 	

Bahir ana 	

Cal ks pe kron 	

Aoa.kia hal he?yar shahzad ka no de 	

Aj dalwai hy 	

Agya 	

Hstl 	

Ho gya kam.dnt wory 	

Cal me its urgent 	

Wait 	

Yar Secretariat cal krna 	

Stand pe khari kr de... Thori der k liye 	

Stamp lagwa lon.... Den pochta hn tu bike khari kr k andar aa ja 	chlo experience kro or 

Han .. Pochta hn agr aj na mila to jama nhi karwaon ag 	

Thokar  	  aewin itnay pese lga liay  

I m almost there 	  good short.Kis brand ki or ktnay ki mili  

Main thokar aa rha hn ... Tyota yahan se nikal para hai 	

Half hur tk lhr pohnch jaon ga 	

Aoa...yar i m cmng to lhr tomorrow 	

Gya tha sec. Aj koi update nhi abi 	  

Aoa.tomorow at o clock 	 whan kisi ki khabrgeeri krni fir shyd wapas aa jae or suba bjay LHR niklay. Keh ra he bjay tk btata he cnfrm  

Thnx 	

Aoa. Bilal dewo bs.stnd yatem khana chok sy qareb taren meto satatn kon sa ha? 	

Hahaha :) asha muje yad aya tv tunr le gay ho? Me ne bag pe rkha hua tha nikaal kr k bhul na jae 	

Chalo shukr he 	

Bohat achay 	

Han v kaka kithay . . . . . ? 	

Oka 	

Pohnch gay?  	 ye to mja aj hi pta chala he.chal us k hath bhijwa dena  

Tickt milay to msg kr dena 	

A ja 	

Bike lock nhi hoti andr nhi aya jana 	

Phr kia krna he? 	

Sahi rush lag rha he 	

Kahan pohncha? 	

Chala he ya nhi? 	

Jaldi nikal 	

Waslam.kb kahan kitna bjay? 	  

I m in 	
Mao colege 	

Han dikh gya me samja tha gur he  	

Shukar wali bat he 	 Nankana sb. Colege ka bhai hspitl ha . Tamardari k ly rokna. 

Rechd 	

Lraye ho gye thi half hr bus late chali 	

Kala shah kaku 	

Abi kala shah kaku k pas 	

Mil gye  . 	
