hum arrange kr den gay boss . lgao chkr is weekend	

Phone eali black tar ek to honi muft ki upr se currnt b fit de gi :) 	

Jan de paii  	

Ya fir DC voltage wali wire lo zra heavy. 	

Fan to dono V  amp k hen but halki tar hui to grm honay lagti he. 	

Sb se best hai k telephone wali tar lga lo	

Tar  kam az kam  - lgao Fir full motion pe chalna fan 	

files mili hen 	

Mil gyen.ktni files hen? 	 koi frk hai un mein? 

Aur kch chya 	

Yar ruf sa asignment ka topic bta do aj me fre hon bna don 	 academy nahi sakon ga.  

Ys  in k trtib lgaty wqt mujhy cal kr lena 	

Chk kr k btana mil gyi wrna fax krta hun 	

Kia scene hy 	

Ksi b eik topc pa bna dn 	

Assalam-o-alikum bahi jan 	

G btyn  	 i came to knw k comprehensiv hona he 

Khariat? 	

Askri atm ka pswd? 	

Saleh ko pta hy 	

Deegro? 	

Kahan ho deegro 	 me ne itnay dekhay .mcbc koi b isi mein nai ata  

A rha he acadmy? 	

Salam. here from sialkot. . How r u? Everything oktok? I m back in Pak. 	  thankyou..  

M outsid 	 it wil b dificult for me to understand so i have asked one of my clasmates to give me his calculus notes n i'm going to his place for mutual study..so i'll manage..thankyou  

Dpt hstl? 	

Outsid dpt 	

Cables ka kia socha he? 	

Aba ji milna chah re thy tumen  k itnaaaaaa fark kese prics mein 	

Wa 	

Zubair se pusha he 	

Aoa.yar jamshed nai aya abi to  fan bhej de us k hath 	

euro per month 	

Research felow ki demand pe depend krta he kun kia hua 	

Ch mail kr dia 	  pani boil nai kr ra?  

Aewin ek aplication fill kr ra hu :) btao ktnay likhu 	

Boss europe mein ek research fellow ki expectd salry ktni honi chahiay in euro 	

Fsd kerha cingci anda aiy 	

Ghar poncha hon chacha.cingci pe wapis a rha tha fsd nhi. 	

Qigci pe fsd ana pe bund bchay gi masag k lia 	

O nai ghar ja rha hn wapis 	

Ganjay ki tee ko aho krna  	

Chingchi pe 	

Han v kider ho 	  he house addres  

Ab nikla hn aon ga to sahi chahay lift le k aon :p 	

Lhr fsd ana ki koshish me 	

Bus stop qe 	 dual way 

Dasna te c chawla 	

Dasna te c chawlo 	

Fsd strike he koi? 	

Ok ok 	

Mtlb 	

coming to fsd via chingchi....? 	

Qadri sab k jilsay main ana ha k PTi k  	

Oh le bus koi nikal nhi rhi fsd k lia kal se koi strike he? 	 

Han v kider ha 	

Menu khud rat vjay pta lga. 	

Chal marzi tari  	

Chal dakh ko mil jay tu theak ha nai tay moj karna 	

Lhr ho k ya fsd 	

Kya howa kider ho 	

Han kal se petrol pumps bnd hen sb jga shyd us liayy na transport bnd ho 	

Nai yar transport to chall ri hey 	

Wo qadri sab ki waja say strick ha transport ki 	

Han g  	

Cam he koi? 	 fsd mein srgodha univ ne campus bnaya e layallpur campus

Nnaai letay ana 	 AP ki b seats hen  lecturer ki b . Ashi opertunity hai

Unhon ne kahan ana he 	

A jao 	

Jana to inho ne lahor k andr kisi jga meeting pe 	

Ji boss kia plan fir 	
