Hun dassso kheyr hey 	  amp tk ki charge kr deta he  

Outsid ur dpt 	

Aoa.kb tk uni ana he? 	 bri mushkil lia us se. . 

Mai rasty mai h n 	  koz ab bad luck chal ri tumari k ye lahor nai ja re   

Cnic n pasport size foto b le k ana 	

Racket ka kch pta he? 	

Yar haftay ko subah bjay se pehlay lhr pohanchna he.arfa karim tower jana he  	

Happy labour day  st maY  	

Waaaaaah 	

Hua kiaaa 	

Sunyplast b lay ana kuch 	

Yar olper b le ana 	

Nikal ayay ya abi ghar? 	

Le ko 	

Le lo 	

Kheray  kg  	

piaz  kg 	

tmato  kg  	

koi sbzi bhidi k ilawa- kg 	

bnana  dzn 	

Aur gobi la ln dosri 	

Kado la ln? 	

Aoa.kia plan he? 	

Wo cards jahan se lia dost ne. Uska no mila? 	

Kb tk cal atnd kr sktay ho? 	

Ni yar urdu bzar ka kaha hy 	

Finl btyn phr 	

Khotay send kr de no 	 raton ka jaga krayay ga :p  

No de uska 	

Yar ramzan ko bhej jaldi acadmy 	

Ramzan Chokidar      	 uni visiting pe  lec perha rha hon  

Card ka size wohi koi a  ka double 	

Acdmy 	

Waslam thek ap snao 	

Aoa.yar acadmy a jyen jb fre ho jyen 	

In class 	

Acha g rate la k apko fone krn ga 	

Aj sham ko wo la aon ga ma aur card ka size bta dn 	

Ma b thk kidr han ap? 	

Aoa.soay ya jagay? 	

Flex nhi lagay.kal ab subah me lagwata hon 	

Me  k around niklon ga .kam par gya 	

To kb tq phnchy ga 	

Kia plan ha 	

Hen abi aj ka kam ho jay ga 	  wo bnanay ka keh dia he tuesdy ko kehta tha milay ga  

Waslam.me f .ap sunao 	 me to khud prayshan hu k ki kru

Ghar ho ya uni a gay? 	

Warid ka no dena yar 	

Ma b thk 	 abi tk koi  logon se pusha he 

Paisy chyen k abi haim? 	  

Aoa kya hal ha 	

Kisay hor nu na dassin 	 ?  

Le lia he 	

Page xpir ho jana he 	

Bati bnd ho gye g me danda de don ga jaldi kr 	

Helo 	

Mail nahi yahin kr de 	

Linkdin profile ka url send krna jaldi 	

Kr de 	

O chacha jb apna profile open kia hota he to jo url hota he wo de 	

Linkdin profile ka link send kr jaldi 	

Sorry ilam nai tha kese dhudna :)  	

Ab mila 	

Lnkd.in/bMhp  	 ab jb number likho gay to pehla digiat real ho ga k bad doosra imag.iota likhna nhi hota  

Nai to ye lo id or pswrd linkd in ka  	

Pakistan 	

