Namaz b parh li ha :-) 	

Hahaha han bch gai to ;-) 	

Shafak shadi ki date kya ha 	 sir ny upload kia paper?  

Wa g wa mubarkan mubarkan 	

I have given your num to one f my student. He is mphill 	

Cal krem 	

Or apni sehat k bi bht khayal rahko jitna bemar raho g utna study me pichy rah  g 	

Welcome sweety 	 

Hum library ja rahy h. A jao 	

Mahnum kindly text me ur email before  pm.  	

Tnx min tk email chek kr lena  	

A block me abi aye h 	

Andr ao smny khary h 	

.  approx. tk scheme mor stop per punch jao g 	

Stop or on way.... 	

Bro atlest reply to karen ta ke me kuch relax karo 	

Ok from Urdu bazar...... 	

Bk name mil gya? 	

Cv ki side per bht ghany badil h 	

Tez brish 	

r rae bt eye shad  	

Refresh kro br br. 	

Not update 	

ap mjy gusa q dilaty ha?  	

mjy gher me ami jan b compare kary tou mjy gusa ata ha	

AOA Ys on way  	

Oka :-) shiza sa rabta hua ha kia ? Us sa pocho ka wo ari ha ka ni mra rabta ni ho rha tm ak br kro agr tmhy msge ay to mjy btna 	

dkhy har insan me koi na koi kami r achae hti h 	

r us khamia b hmy buri nae lgti 	

Ok i txt her 	

Ok txt kr diya h 	 din hn mndy tuesday tk mra acount bn jay ga phr msla ni ho ga  

Ghar ja rhe ho?  	filter k me ny thk kr li ha 

spirit?  	

ks bt py ap ny kaha? 	

ks ny kaha k ap bury ha?  	

yh ap mry dil sy puchy k ap kaicy ha r mry liy kia ha? 	

r partner just profit me nae loss me b sath hty ha 	

Ok thank u very much 	

r phli bat nae he koi gurbat ay gae  	 mjy thk krni ati ha?  

r agr ay gae b tou aik achy dost r parnter ka pata tb he chalta ha.  	

AOA uni main ho kia? 	

Kr den 	

Me too.  	

seminar h a block me a rm me wahan ai ho 	

Lb kaha h me a jao?  min k liye 	

r aici koi khawish b nae karu gae jo ap puri na kary sky. 	

Which rm? 	

Madm numbr btao? 	 r us ki waja ap h  

me manti hu k eyeshad ki bt py me ny ap sy larai ki ha  	aub jalny wali chz the jal gae

but eye shad itne mehnge nae h k ap us sy complx ka shekar hu jay 	

Tnx nd best of luck 	

Ap ko bhe.. 	

Mere seat rahk lo 	

r allah ka shukr ada krna chaey 	

muhbt me buht taqat hti ha 	

mjy ap ka sath 	

mjy paisa chaey?  	

ap ko lgta ha aisa? 	

har kici ka apna stmna hta ha 	

File me uski receipt pari he  ka tha i think 	

hmari lrae kici khawsh py nae 	

tou ap ny yh kiu kaha k agr ap meri khawishat puri na kr sky tou me ap ko chor dou gae?  	

dosri bt yh k chorny ki bt khawishat ki waja sy nae hui the 	 r ap ki waja sy meri dal sar gae h  

yh sch rae the k mera piar kitna kamzur h 	

nashta kia tha? 	

tnxn kia the? 	

r kia soch ray thy? 	

aik bt tou tay ha janab  	

chahy kuch b ho jay apne comitment zarur puri krti ho 	
