Lolz 	

Kahan ho ? Ghr ?  	

Assalamualikum r u in comsat?  	 interim govt will come and thn reelections under army. Election comission might be reestablished as well.  

)???? ???? ??????( 	

Soi nhi? 	

Waitng bati 	 as a nation apne apko sudharo

Americans and Britians issued their statements over the situation of Islamabad.  	

They showed concerns over the current grim political egitational crisis. They also asked to resolve the situation by dialogue.  	

Pakistani leaders zindabad. 	 especially masoom awaam ka jo ink pechay lage the. 

You deserve all the credit on this international defame of our country again. 	

Ay Allah mere Pakistan ki hifazat farma and mere mulk inn jhotay	

Aur ay Allah ham iss qabil to nae magar mere logo ki saloon ki qurbaniyo k sileh mein hamain naik	

Pakistan zindabad. 	

Gud. Waito. 	

Ab kren 	  shame!  

Hmm 	

Kia hua 	

Yar main subah aaon gi. 	

Reachd 	

March in red zone 	

Pohnch gay? 	

After LaaL Masjid 	  stuck in trafic

Dakho dakho ye politician kon hain	

Hmm sahi 	

Kahan pohnchay? 	 free ho k ring krna amma ne bat krni  

Oho aj to safar b lmba he 	

Gud.kia kr rha he pola 	

Chal pari bus? 	

GTd 	

Dr hospital 	

De do yar  ka fon aya tha aplication ka poch rha tha 	

Aoa.yar aplication de di? 	

NEnd kharab 	

Ren ren 	

Ji. 	

 min wash room hn ab 	

Dy dta hn 	

Ni abi ni d 	

to 	

Ho gya test 	

Pswrd kia he? 	

Kb ana he 	

Han ji kya hal hai? 	

Bus   	

RICE HUSK GASFIERS & STOVES  	 keys rehan k pass hain

Nai shel k pump pe 	

Aa ja alied mor 	

Pohanch gayay? 	

Band kr fon 	

Pognch gya 	

Chal lga chakar yar.nthng esp visitng lec 	

Chor yar goli mar siasat ko.lhr kb a rha he? 	

Hmm. Gud yar laga reh. Kuch na kuch ho he jaye ga. 	

Yar lhr is month k last ya next month k start me mind to banaya hoa ha. Lets see! Tu suna kia chal raha ha? 	

Saleh lay gaya hai application 	

Kr di mail? 	

Boss bachon ka physics ka papr hai kal or aj unko numerical krwanay. tk fsd pohncho 	

Fre hain? 	

Boss kb ana aj 	

Reched 	

Haha 	

Sahi bta. k electricity ka bil he or subah last date he.na kraon jama? 	

Dear Customer 	

Dekh ley   to idher he ho gaya.... Tha tha tha... iK zindabad 	

Na kara... Apna bhe   ka aaya thaa IK ney bachwa dia ab... 	

Yaaaayyyy.... Aaj sey no tax or bill.... Mubarkan.... 	

A funny saying by Imran Khan 	
