kia sch ray thy? 	

kia kia kam ha ic wk ka hmy? 	

q ha?me ny kia na? 	

kia ker rae ho? 	

ap parshan ha na? 	

ap tenst h na? 	

Shahwaiz se kut khayay ga 	

Us k dar pe   Sukoon   milta hai  	

Uski   Ibadat   se   Noor   milta hai  	 phr ap nxt time apni dal k bth jay gay  

Jo jhuk giya   KHUDA   k sajday main  	

Usay kuch na kuch   Zaroor   milta hai  	

juma mubarik... 	

Us bandi se mila hon js ka baby he us ne b aj joining di he 	 tou wo tou aub me shadi k bd b ap sy nae lo gae  

Han to sahi keh rha hn 	

Kpray dhoyay 	

Dnd p jo bnd kia tha us main jis main red basket etc thi 	

Barish k bad bht fit mausam hua he 	 agr kici r ny sufr kia tou me ku karu?me tou aici he hu   

Ahan to gari kraon phir kal ki a jayen. Sofia ko mon ko bhej den gay 	

Ho gya paper? 	

Clas to koi nai phir chali jatin 	jis sy hm muhbt krty ha usy us ki khamio k sath apnaty ha 

Chali gyen ghar ya  bjay jana he? 	

Eid ka maza lia sher khorma kha k? 	

Chota to koi baat nahi. Mes main mes to nahi? 	

G beta  	

Mai karti na :-X 	

Tm.to tun hoty 	

Wahhh :-P  	

Wjh -_- 	

#NAME?	

Dal mat khya kro tumhy ni suit krti 	

Unko bolo rain coat la d@in 	

Ty hor  	

La b dain gy 	

Bhuhaha  	

I.r na bun 	

Ap log gaye?  	

Sir gaye? 	

Yooo  	

Kab ayen gai? 	

Kabhi b mat bhejna wapas plz  : tak to plz uni k pas b na bhatakna 	

Nai uni nai ana  	

mai apko rat mai btati kahan n kab 	

Uski behan sy ho gyi hai bat  	

Ab wo khud manage karain.gi :-X 	

Kuch khas nhi he juma k bad ghar chala jaon ga bjay k around 	

Gud kia. Kya khaya? Mes kaisa hai? 	wo lakho sy bhtr ha

Whats up? 	ap ki muhbt he meri sub sy bri dolat ha

Wo to kr lia lakin khail main mast hota hai. 	 ap ki support ap ki care chahy  

Shahwaiz ko shower p manaya ja raha hai 	

Gud 	

Ahan. Ab thek hain? 	 me ny phly b kaha tha k ap mjy meri khamyo k sath apny gay  

Doosray ki cv nhi aye usay cal krta hon send kray 	

Kaisi nend ai? Thakan utri? 	tb hui the jb ap ny anti sy compare kia tha

Gud. Jag gayay. Nadeem ka msg tha k timetable mail karon. Kr di hai. 	

Thank u mam . 	

Mam  i cant come today  	

Hmm thora thora hehe 	

Muah love u too. Just got into office. Trying to absorb happiness of sitting on the other side of table :) 	

Wasalam. Yes mam i will IA. 	

Mam its raining  this time 	

Asalamo alaikum :-)  	

Mera thri hona  	

Videos bht hain 	

apna btana ap 	

Mera to ab subha hi hoga jo hoga 	

Yo  	

Kya panga? 	

Prh liye thy  	

choty sy 	

Samjhny ki nakam.koshsh kr rhi thi 	

Net chal raha? 	  he to saal month ka  

So gayay? 	

Cpu main maslay wala na lain 	

Jag rahay hain? 	

Who is this? 	

Achi baat hai .. :D mein tumen faida honay bhi nai doon gi :D 	

Menay khana kha lia classes le k wapis agai hoon ab namaz parhnay lagi hoon 	
