shaya sy bus ka puch 	

Ni is wakt scene ulta chal raha hai ... Ap log ko kab ka pata tha ? 	

Acha .. Ni roon gi  	

And tumen to mazza a rha hona chye .. Fast driving to tm khud b boht krtay ... Nahi ? :/ 	

Kia matlab? 	

sir ap plz apny bhalf py bt ki jy ga.plz do not specify me 	

Gud theek hein? 	

Where r u? 	

SHAYA wali bus kun c h? 	

bahria wali kun c bus ha? 	

Pohnch gye thin khryyt se? 	

:-P ap kuch keh b dain to asar ni hna 	

Tabiat sy majbor hain :-X 	 wari send kita c ty tad v nai hoya  

kr li asnment? 	

Bs wo khudi ni a rhy 	

room me ana 	

Sir ni a rhy kal :-P 	

Kal a rahn ap? 	

q k mri personaliy buht aggresve h 	

me bilkul b intersted nai hu. 	

a b jao aub 	

yh ap ko pata ho ga? 	

wasy yh buht buri bt h 	

sub groups sy un ki algo ki ppt ly lna 	

me abi gher ho 	

aj jb me ao tou hm os ki slidx na revise kr ly? 	

kitny ganty lgay ha? 	

os ki slidx parhe h? 	

shahd 	

kia kr rai ha? 	

ap kaha h? 	

jana ha tm ny 	

r u fre nw? 	

tm kaha hu? 	

Have a nice day 	

What's the rush ? Chacho ko gussa to ni aya hoa ?  	

Ahan baki kya araha hai? 	

Maza araha hai? 	 paper download kr k mix kr den  

:) muah. 	

Have a very gud job first day. Luv u. 	

N bjai na pochny lg jya kro 	

Abdullah sy kra ly :-P 	

Acha tb tak weka ka latest version bta do 	

Pehly kya dramai thai? -_- 	 

Wjh ab kun :-X  	bhuki hu buht

Chup beth 	pani ly k 

Phr mai b tb :-P 	 kaha ha mjy buht bhok lg rae ha.  

Ni abhi adhy  	 mjy buht  buhk lage  

Koi drama a ra tha 	 whr u?  

Hogi polyfx  	

N aik or b hy oint koi 	 ap k sath khana tha  

Laga laiti 	 whr r u?  

Itna k chala ni ja ra tha end mai  	

Bs khon ni.nikla 	

Umeed to hy  	on da way

U? 	 rest kr k ana.r me ny a gae tou tb tk namaz par lo gae  

Gup mari ja bs apni random 	

To laini?  	

cell sy kum.ki daikh laity. 	

Itni lmbi jumps lagaty tum :-X 	

Batry ka kiya pata? 	

Ho gya lptop thek? 	

Sara tym galon mai lg gya 	

Abhi to milai :-X 	

Hain?  	

Ap jab unk ghr gaye tb nai thai wahan? 	

Ahtiyatan rakh laity na 	

Itni dor aye paisai to zada laty. 	

Masla kya hy? 	

Chup raho  	
