Tmhary wali me e tha msla thek kr di hn 	

Abey chnge ho sakti txt file ye bta 	

jb fb py aik he post py  ono comment kry gay tou sub ka kam asan ho ga na 	

Me lab me hun thra prblm ha slides me 	

Acha name.cvs rakh k  	

N file type jo hota wo? 	

rhny day ap tou phly e sary hoy ha 	

Naraz ho kya reply ni kr rai 	

Wo cal pe btaun g unho ne software bnana ha jo detect kr k btay ga k msg male ka ha ya female ka aur ks age grp ka ha flan flan:-P 	

Yar ap bunao or save kro  	

Phr btao 	

Cvs ki b bht types 	

me sub ka kam he asan kre rai hu 	

Acha  	

Tutorial mai cvs likha 	

Ab? 	

agr me ap sy kuch pucho tou ap bura nae many gay na 	

Bhaiya hmen asignment mili ha aj   msg krny hn apny sent item se marks ki ha ye. Aur  nd asignment me   apny fb k coments aur post snd krni ha:-P:-Dsenior ka research wrk ha ye 	

Kya ho rha ha jnb 	

Arff file type krni prni? 	

phr ham log kal fb py kam kary gay ic py b sath 	

Me ne rat shafak ko khwab me dkha shafak k ghr me orange clr ka paint hua ha:-Dpr boht pyara lg rha tha:-D:-D 	 buht nend ati ha thkny ki waja sy  

Sahi 	

Hmm ganda b utna he? 	 aik lafz tk nae lika paper ka  

Welcme main kya dance party hai? 	

Kaisa laga ghar? 	 jag rae ho?  

Ahan. Sahi 	

Gud. Khain khain.  	

ap heran nae hoy ic asignment sy 	

Jain maza karain. Phir rest karain. 	nashta kr lia ha

Ap pohanch gayay yeh btain saman k mamay. 	

Ios wali videos kahan rakhn thn mere lptp mai? 	

Link do :-X  	

Retry -_- 	

N agr na hua to subha  : adil k laptop pr 	

Kun k karna :-X  	

Tumny kahan sy sekha rha? 	

Us din jo ios k msg bhejy thy tumny  	

Wo hain? 	

ghr tou puhnch jao ?tmy dramo ki pari h 	

me apna phn lab me bhul gae the 	

its nt gud 	

ap sy kic ny kaha k me late fre hui? 	

q ?kia matlb?me smje nae? 	

mery pas b itna fre time nae ha wo tou mjy asinment mili the.thats y talking u 	

lunch me kia khaya? 	

i am talking u and u r sleeping 	

sms wala kam start kr do? 	

tou me ny manualy apna name and data send kr dia ha 	

is it same no at which i am sending? 	

no sir 	  we will meet  

mjy btay same num py msg krna ha title b r msgz b? 	

dafa hu  	 wasy b ap ko hr wakt he ati rhti h  

chaly thk ha 	 

agr yh hmary msg nae pary gay tou en ko pata kaicy chaly ga k es rol num ny msg kia ha 	

cake khaya tha 	

ami ko bta du k me gher a rae hu 	

me ap sy kati hu 	

yh ks dpt ki teacher? 	

ap mjy wo numb msg kr dy.me kici sy b bt karu gae tou usi ko use karu gae 	 Mam Ambereen 

ap so gay kia 	

ap k pas wo numb ha js py sir ny txt krny ko kaha h 	

Khon dai sakta :-D 	

All@h jny :-P  	

Gft hi la saktA shyd bs :-X 	

Wjh wjh na kia kr 	

Kuti  	 me ny just aicy he pucha h  

Apka bhai apk liye kya kr sakta? :-P 	

its iqra muneer here 	

from mscs. my reg no is fall _mscs_ _ciit lhr. 	

subject advance algorithm analysis 	

teacher:dr umair. 	

Ama t.v  	

