Papa chusain.mar rhy :-P 	

Mai soun ri 	

bhai rom 	

Ab kun atai?  	

Season khatam u said 	

Soch rhi  bjai parhon  	

Ap? 	 weka tool sir ny corct kia tha weka  

Ly milny jna us sy -_- 	 ap k ilawa kici k sath comfortabl fl nae krti ic liy ap sy  

Tumhara bhai kn c branch jata aj kal? 	

Prh ri thi  	

Soch rhi chptr kr loun jaisai taisai 	 mjy nae krni ap sy koi bt  

Kun?  	

U said rehta 	

Apka jo kam reh gya kr lia? 	

Itni kya jaldi hy? :-X 	 lenty msg kr  

Faizi k sath chalai jaty  : -_-  	

Wo keh b raha tha 	

Chalo :-X  	

Abhi na jao 	

Uni mai kr laina 	

Area safe hota to bat b thi. 	

Lakh rupiya dao pr laganai wali bat :-X 	

Itni rat ko laptop n bike ly jna us area mai is nt safe 	

Imprtnt kam kr ri aik 	

Wapsi pr shampoo laity ana 	

Kn sa algo? 	 r e sar jay gay  

To reply to kro -_- 	

Weka pe kaam.kia hy.tmny? 	

Weka ka set up hai? 	

Majal hy kbhi kam ayen 	

Kbhi b ni kia use? :-X 	

Phr data mining mai jhak mari? :-X 	

Yr apny weka use kia hua? 	

To uni kaisai manage karain hi sath? 	

Sahi..  	

Abhi sy chotiyan b shuru :-P 	

Wah kitni pay hy? :-P 	

Ab uni ati hain? 	

Sona hai bari job lag gayi hai apki :-P 	

Mera calculator dai daina kal chahye mjhe.. 	

Bhar mai ja  	

Koi zarorat ni mjhe ni jna to mat jao 	

Plan khatam bat khatam 	

Apni ly a itna hy to :-X  	

Bukwas na kr 	

To jo plan bunata woi gari lata :-X  	

g ni hum  no 	

Ni g  	

Apka plan hy uska ni 	

Kal done hy  	

Tum kb free? 	

Papa ki ainak reh gyi oper? 	

Pc aya hn bs aa raha hn 	

Agr bryani na hui to 	

Abhi to i m going home. Baki kl daikhon gi. 	

Jan chot ti 	

How ? Nazar nahi arahi mjy. 	

Nahi. 	

Koi bnda b nahi mil raha meri replacement. 	 comp ki table py para tha  

Yar kr rahi hon bht kam hai end nahi ho raha. 	

Nahi bna. 	

Okay mam. 	 aj koi nae hui hmare ppt?  

Okay thanks mam. Is it required at comsats ? 	

Wasalam mam. First of all I am interested if there is any possibility they can consider MS continuation cases ? 	

Aik to bnaya baki bna rahi hon. 	

Us ko khila pila k ai thi. 	

Yar paper bna rahi hon. Feling stuck. 	

Pta nahi. 	

Ji 	i dnt hv android phn

Mam m on my way m late due to mess in hstl 	

Ok mam 	tayab sahb said that he ds not have ur resign

Mam  then shud i  come ?? 	

Mam is waqas also presenting in ur class at  . 	mar ja

M comming mam  	 bt mera tou sar kha lia ha  

On my way 	
